1111111111111111111111111111111111
100C00C00001000C000010000C0C000001
1C00001000010000000010C0000000C001
100C0011000C0C00000011111101111111
1000000100011111000000000C0C000001
100C00C10001000C00000C000100000001
1000000101110000000000000100C00001
1C10011111E01000101001000100011111
1110010010101010001C010C0C00010C01
1P000000C00C00000C0000C00000000001
1111111111111111111111111111111111