111111111111111111
10P010100011000001
10000000001101C001
1000111C000C000001
110110100011010001
100010101011011001
100000001011C11001
101111111011111111
10100000000001CCC1
101C10000000010001
1C1111100000010001
101E00000000000001
101100110000010001
100100010111110111
100000010001000001
110000010001000001
111C1111C0010C0011
111111111111111111
