1111111111111111111111111111111111111111111111111
1000000000000000P00000000000000000000000000000001
1000000000000000000000000000000C00000000000000001
1000000000000000000000000000000000000000000000001
1000000000000000000000000000000000C00000000000001
1000000C00000000000000000000000000000000000000001
10000C000000000000000C000000000C00000000000000001
10000000000000000000000000000000000000C0000000001
100000000000000000000000000000C000000000000000001
1000000000C00000000000000000000000000000000000001
1000000000000000000000000000000000000000000000001
1000000000000000000000C000000000000C0000000000001
100000000000C000000000000000000000000000000000001
100000000000000000000000000C000000000000000000001
100000000000000011111111111111111111111110C000001
100000C000000000100000000000000000000000100000001
100000000000000010111111111111111111111C100000001
100000000000000010100000C000C00000000000100000001
1000000000000000101011111111111111111111100000001
10000000000000001010100000000000000000C0000000001
1000C00000000000101010000000000000000000000000001
1000000000000000101010000C00000000000000000000001
10000000000C00001010111100000C0000000000000000001
100000C00000000010100000000000000000000000C000001
1000000000000000101111111111111000000000000000001
100000000000000010000E000000001C0000000C000000001
1000000C00000000111111111111111000000000000000001
10000000000000C0000000000000000000000000000000001
1000000000000000000000000000000000000000000000001
10000000000000000000000C000000000C000000000000001
1000000C0000000000000000000000000000000000C000001
1000000000000000000000000000000000000000000000001
1000000000000000000000000000000000000000000000001
1000000000000000C000000000000000C0000000000000001
100000000000000000000000000000000000000C000000001
10000C000000000000000C000000000000000000000000001
1000000000000000000000000000000000000000000000001
1111111111111111111111111111111111111111111111111